players 2
.................
..3...........3..
.................
da......F......eh
.................
..3...........3..
.................